0000100000
0001210000
001e4p2000
0001210000
0000100000