1e00000042
012p3a4100
00023p3000
012a03e100
11e0000p42