eeepepepee
e00000000e
eas23432ae
ea000040ae
ea0e34p0ae
ea02p000ae
ea0e4p30ae
ea000000ae
pepepepeep